11111111111111111111
10100000000000000001
11010000000000000001
1C1C000000000P000001
10100000000000000001
10010000000100000001
10000000000E10010011
11111111111111111111
